[
  {
    "type": "mapgen",
    "method": "json",
    "om_terrain": "wasp_tower_even_1",
    "object": {
      "fill_ter": "t_open_air",
      "rows": [
        "                        ",
        "          ::            ",
        "         aaaaaaaa       ",
        "         aR,,,,Ra       ",
        "        :a,,,,,,a#      ",
        "         a,,::,,a       ",
        "         a,,::,,a       ",
        "        :a,<>,,,a#      ",
        "         aR,,,,Ra       ",
        "         aaaaaaaa       ",
        "            :  OOOOOOO  ",
        "         O     OOOOOOO  ",
        "                        ",
        "              O         ",
        "                        ",
        "                        ",
        "          O             ",
        "                        ",
        "                        ",
        "               O        ",
        "                        ",
        "                        ",
        "                        ",
        "                        "
      ],
      "palettes": [ "wasp_palette" ]
    }
  },
  {
    "type": "mapgen",
    "method": "json",
    "om_terrain": "wasp_tower_even_2",
    "object": {
      "fill_ter": "t_open_air",
      "rows": [
        "                        ",
        "          ::            ",
        "         aaaaaaaa       ",
        "         aR,,,,Ra       ",
        "        :a,,,,,,a#      ",
        "         a,,::,,a       ",
        "         a,,::,,a       ",
        "        :a,<>,,,a#      ",
        "         aR,,,,Ra       ",
        "         aaaaaaaa       ",
        "            :           ",
        "                        ",
        "                        ",
        "                        ",
        "                        ",
        "                        ",
        "                        ",
        "                        ",
        "                        ",
        "                        ",
        "                        ",
        "                        ",
        "                        ",
        "                        "
      ],
      "palettes": [ "wasp_palette" ]
    }
  },
  {
    "type": "mapgen",
    "method": "json",
    "om_terrain": "wasp_tower_odd_1",
    "object": {
      "fill_ter": "t_open_air",
      "rows": [
        "                        ",
        "                        ",
        "                        ",
        "         :R,,,,R        ",
        "          ,    ,        ",
        "          ,    ,        ",
        "         #aaaa ,        ",
        "         #a><a ,:       ",
        "         #Raaa,R        ",
        "                        ",
        "                        ",
        "                        ",
        "                        ",
        "                        ",
        "                        ",
        "                        ",
        "                        ",
        "                        ",
        "                        ",
        "                        ",
        "                        ",
        "                        ",
        "                        ",
        "                        "
      ],
      "palettes": [ "wasp_palette" ]
    }
  },
  {
    "type": "mapgen",
    "method": "json",
    "om_terrain": "wasp_tower_odd_2",
    "object": {
      "fill_ter": "t_open_air",
      "rows": [
        "                        ",
        "                        ",
        "                        ",
        "         :R,,,,R        ",
        "          ,    ,        ",
        "          ,    ,        ",
        "         #aaaa ,        ",
        "         #a><a ,:       ",
        "         #Raaa,R        ",
        "                        ",
        "                        ",
        "                        ",
        "                        ",
        "                        ",
        "                        ",
        "                        ",
        "                        ",
        "                        ",
        "                        ",
        "                        ",
        "                        ",
        "                        ",
        "                        ",
        "                        "
      ],
      "palettes": [ "wasp_palette" ]
    }
  },
  {
    "type": "mapgen",
    "method": "json",
    "om_terrain": "wasp_tower_top",
    "object": {
      "fill_ter": "t_open_air",
      "rows": [
        "                        ",
        "                        ",
        "                        ",
        "          aaaaaa        ",
        "          a,,,,a        ",
        "          a,RR,a        ",
        "          a,RR,a        ",
        "          a>,,,a        ",
        "          aaaaaa        ",
        "                        ",
        "                        ",
        "                        ",
        "                        ",
        "                        ",
        "                        ",
        "                        ",
        "                        ",
        "                        ",
        "                        ",
        "                        ",
        "                        ",
        "                        ",
        "                        ",
        "                        "
      ],
      "palettes": [ "wasp_palette" ],
      "place_nested": [
        {
          "chunks": [ [ "null", 40 ], [ "radio_tower_2x2_map", 40 ], [ "radio_tower_2x2_holdout", 10 ], [ "radio_tower_2x2_sniper", 10 ] ],
          "x": 10,
          "y": 5
        }
      ]
    }
  },
  {
    "type": "mapgen",
    "method": "json",
    "om_terrain": "wasp_tower_roof",
    "object": {
      "fill_ter": "t_open_air",
      "rows": [
        "                        ",
        "                        ",
        "                        ",
        "                        ",
        "                        ",
        "                        ",
        "                        ",
        "                        ",
        "                        ",
        "                        ",
        "                        ",
        "                        ",
        "                        ",
        "                        ",
        "                        ",
        "                        ",
        "                        ",
        "                        ",
        "                        ",
        "                        ",
        "                        ",
        "                        ",
        "                        ",
        "                        "
      ],
      "palettes": [ "wasp_palette" ]
    }
  },
  {
    "type": "mapgen",
    "method": "json",
    "nested_mapgen_id": "radio_tower_2x2_holdout",
    "object": {
      "mapgensize": [ 2, 2 ],
      "place_furniture": [ { "furn": "f_camp_chair", "x": 1, "y": 0 }, { "furn": "f_makeshift_bed", "x": 1, "y": 1 } ],
      "place_loot": [
        { "group": "camping", "x": 1, "y": [ 0, 1 ], "chance": 50, "repeat": [ 2, 3 ] },
        { "item": "blanket", "x": 1, "y": [ 0, 1 ], "chance": 50, "repeat": [ 1, 2 ] },
        { "item": "can_drink", "x": 1, "y": [ 0, 1 ], "chance": 30, "repeat": [ 2, 3 ] },
        { "item": "can_food", "x": 1, "y": [ 0, 1 ], "chance": 40, "repeat": [ 2, 3 ] },
        { "item": "can_food", "x": 1, "y": [ 0, 1 ], "chance": 40, "repeat": [ 2, 3 ] },
        { "item": "sleeping_bag", "x": 1, "y": 1, "chance": 40 }
      ]
    }
  },
  {
    "type": "mapgen",
    "method": "json",
    "nested_mapgen_id": "radio_tower_2x2_sniper",
    "object": {
      "mapgensize": [ 2, 2 ],
      "place_furniture": [ { "furn": "f_camp_chair", "x": 1, "y": 0 } ],
      "place_loot": [
        { "item": "corpse", "x": 1, "y": 0 },
        { "group": "mon_zombie_soldier_death_drops", "x": 1, "y": 0 },
        { "item": "survivor_scope", "x": 1, "y": 0, "chance": 70 },
        { "item": "can_drink", "x": 1, "y": [ 0, 1 ], "chance": 70, "repeat": [ 2, 3 ] },
        { "item": "3006", "x": 1, "y": 0, "chance": 40 },
        { "item": "remington_700", "x": 1, "y": 0, "chance": 80, "ammo": 100 }
      ]
    }
  },
  {
    "type": "mapgen",
    "method": "json",
    "nested_mapgen_id": "radio_tower_2x2_map",
    "object": {
      "mapgensize": [ 2, 2 ],
      "place_loot": [
        { "item": "survivor_scope", "x": 1, "y": 0 },
        { "item": "survivormap", "x": 1, "y": 0 },
        { "item": "3006", "x": 1, "y": 0, "chance": 40 }
      ]
    }
  }
]
