[
  {
    "type": "mapgen",
    "method": "json",
    "om_terrain": "wasp_tower_even_1",
    "object": {
      "fill_ter": "t_open_air",
      "rows": [
        "                        ",
        "          ::            ",
        "         aaaaaaaa       ",
        "         aR,,,,Ra       ",
        "        :a,,,,,,a#      ",
        "      X  a,,::,,a       ",
        "    XXXXXa,,::,,a       ",
        "    XX_XXX,<>,XXaX      ",
        "    X___XXR,,,XRXXXX    ",
        "   XX____XXXXXX___XX    ",
        "  XX______________XX    ",
        "  X_______________XX    ",
        "  X_______________XX    ",
        "  X_______________XX    ",
        "  XX______________XX    ",
        "   XX_____________XX    ",
        "    X____________XXX    ",
        "    X___________XXX     ",
        "    XXX________XXX      ",
        "     XXXX____XXXX       ",
        "       XX__XXXXX        ",
        "        X__XX           ",
        "                        ",
        "                        "
      ],
      "palettes": [ "wasp_palette" ]
    }
  },
  {
    "type": "mapgen",
    "method": "json",
    "om_terrain": "wasp_tower_even_2",
    "object": {
      "fill_ter": "t_open_air",
      "rows": [
        "                        ",
        "          ::            ",
        "         aaaaaaaa       ",
        "         aR,,,,Ra       ",
        "        XX,,,,,,X#      ",
        "       XXXX,::XXXXX     ",
        "    XXXX aXXXXX,aXX     ",
        "    X_   a,<>,,,a XX    ",
        "    X ...aR,,,,Ra  X    ",
        "   XX xxxxxxxxxxx. XX   ",
        "   XX xOxOxOxOxOx.  X   ",
        "  XX_xxxxxxxxxxxxx. X   ",
        "  XX xOxOxOxOxOxOx. X   ",
        "  XX xxxxxxxxxxxxxx X   ",
        "  XX  xOxOxOxOxOxOx X   ",
        "  XX  xxxxxxxxxxxxx X   ",
        "  XXX  xOxOxOxOx..  X   ",
        "   XXX xxxxxxxxx.  XX   ",
        "    XX  xOxOxOx.  XX    ",
        "    XX  xxxxxxx  XX     ",
        "    XXX_ _     _XX      ",
        "      XXXXXXXXXXX       ",
        "         XXXXX          ",
        "                        "
      ],
      "palettes": [ "wasp_palette" ]
    }
  },
  {
    "type": "mapgen",
    "method": "json",
    "om_terrain": "wasp_tower_odd_1",
    "object": {
      "fill_ter": "t_open_air",
      "rows": [
        "                        ",
        "                        ",
        "                        ",
        "         :R,,,,R        ",
        "          ,    ,        ",
        "       XXX,    ,        ",
        "    XXXXXXXXXa XXXX     ",
        "    XXX   X><XXXX XX    ",
        "    XX    RXXX,R   X    ",
        "   XX  .........   XX   ",
        "   X   ..........   X   ",
        "  XX   ..........   X   ",
        "  XX  ............  X   ",
        "  XX  ............  X   ",
        "  XX  ............  X   ",
        "  XX   ..........   X   ",
        "  XX   ..........   X   ",
        "   XX  .........   XX   ",
        "    X    ......   XX    ",
        "    XXX   ...    XX     ",
        "    XXXX      XXXX      ",
        "      XXXXXXXXXXX       ",
        "         XXXXX          ",
        "                        "
      ],
      "palettes": [ "wasp_palette" ]
    }
  },
  {
    "type": "mapgen",
    "method": "json",
    "om_terrain": "wasp_tower_odd_2",
    "object": {
      "fill_ter": "t_open_air",
      "rows": [
        "                        ",
        "                        ",
        "         XXX  XXX       ",
        "       XXXRXXXXRXX      ",
        "      XX  XX  XX XXX    ",
        "   XXXX   ,    ,   X    ",
        "   X     #aaaa ,   XX   ",
        "   X     .a><a ,.   X   ",
        "  XX  ....Raaa,R.   XX  ",
        "  X   .....X......   X  ",
        " XX   .X.......X..   X  ",
        " X   ..............  X  ",
        " X   ........X.....  X  ",
        " X  .....X.........  X  ",
        " X  ............X..  X  ",
        " X   ..............  X  ",
        " X    .X.....X....   X  ",
        " XX   ...........    X  ",
        "  XX  ....X....X    XX  ",
        "   X    .......    XX   ",
        "   X       .      XX    ",
        "   XXX           XX     ",
        "     XXXX     XXXX      ",
        "        XXXXXXX         "
      ],
      "palettes": [ "wasp_palette" ]
    }
  },
  {
    "type": "mapgen",
    "method": "json",
    "om_terrain": "wasp_tower_top",
    "object": {
      "fill_ter": "t_open_air",
      "rows": [
        "                        ",
        "                        ",
        "         XXXXXXXX       ",
        "       XXXaaaaaaXX      ",
        "      XX  a,,,,a XXX    ",
        "   XXXX  .a,RR,a   X    ",
        "   X    xxx,RR,xxx XX   ",
        "   X ...xOx>,,,xOx. X   ",
        "  XX xxxxxxxxxxxxx. XX  ",
        "  X  xOxOxOxOxOxOx.  X  ",
        " XX xxxxxxxxxxxxxxx. X  ",
        " X  xOxOxOxOxOxOxOx. X  ",
        " X xxxxxxxxxxxxxxxxx X  ",
        " X xOxOxOxOxOxOxOxOx X  ",
        " X xxxxxxxxxxxxxxxxx X  ",
        " X .xOxOxOxOxOxOxOx. X  ",
        " X  xxxxxxxxxxxxxxx. X  ",
        " XX  xOxOxOxOxOxOx.  X  ",
        "  XX xxxxxxxxxxxxx  XX  ",
        "   X ...xOxOxOx..  XX   ",
        "   X   .xxxxxxx.  XX    ",
        "   XXX    ...    XX     ",
        "     XXXX     XXXX      ",
        "        XXXXXXX         "
      ],
      "palettes": [ "wasp_palette" ],
      "place_nested": [
        {
          "chunks": [ [ "null", 40 ], [ "radio_tower_2x2_map", 40 ], [ "radio_tower_2x2_holdout", 10 ], [ "radio_tower_2x2_sniper", 10 ] ],
          "x": 10,
          "y": 5
        }
      ]
    }
  },
  {
    "type": "mapgen",
    "method": "json",
    "om_terrain": "wasp_tower_roof",
    "object": {
      "fill_ter": "t_open_air",
      "rows": [
        "                        ",
        "                        ",
        "        *********       ",
        "       ***********      ",
        "      *************     ",
        "    ****************    ",
        "   ******************   ",
        "  *******************   ",
        "  ********************  ",
        "  ********************  ",
        " *********************  ",
        " *********************  ",
        " *********************  ",
        " *********************  ",
        " *********************  ",
        " *********************  ",
        " *********************  ",
        " *********************  ",
        "  ********************  ",
        "   ******************   ",
        "   *****************    ",
        "   ****************     ",
        "     *************      ",
        "        *******         "
      ],
	  "palettes": [ "wasp_palette" ],
	  "terrain": { "ó": "t_roof_paper_hard"}
    }
  },	
  {
    "type": "mapgen",
    "method": "json",
    "nested_mapgen_id": "radio_tower_2x2_holdout",
    "object": {
      "mapgensize": [ 2, 2 ],
      "place_furniture": [ { "furn": "f_camp_chair", "x": 1, "y": 0 }, { "furn": "f_makeshift_bed", "x": 1, "y": 1 } ],
      "place_loot": [
        { "group": "camping", "x": 1, "y": [ 0, 1 ], "chance": 50, "repeat": [ 2, 3 ] },
        { "item": "blanket", "x": 1, "y": [ 0, 1 ], "chance": 50, "repeat": [ 1, 2 ] },
        { "item": "can_drink", "x": 1, "y": [ 0, 1 ], "chance": 30, "repeat": [ 2, 3 ] },
        { "item": "can_food", "x": 1, "y": [ 0, 1 ], "chance": 40, "repeat": [ 2, 3 ] },
        { "item": "can_food", "x": 1, "y": [ 0, 1 ], "chance": 40, "repeat": [ 2, 3 ] },
        { "item": "sleeping_bag", "x": 1, "y": 1, "chance": 40 }
      ]
    }
  },
  {
    "type": "mapgen",
    "method": "json",
    "nested_mapgen_id": "radio_tower_2x2_sniper",
    "object": {
      "mapgensize": [ 2, 2 ],
      "place_furniture": [ { "furn": "f_camp_chair", "x": 1, "y": 0 } ],
      "place_loot": [
        { "item": "corpse", "x": 1, "y": 0 },
        { "group": "mon_zombie_soldier_death_drops", "x": 1, "y": 0 },
        { "item": "survivor_scope", "x": 1, "y": 0, "chance": 70 },
        { "item": "can_drink", "x": 1, "y": [ 0, 1 ], "chance": 70, "repeat": [ 2, 3 ] },
        { "item": "3006", "x": 1, "y": 0, "chance": 40 },
        { "item": "remington_700", "x": 1, "y": 0, "chance": 80, "ammo": 100 }
      ]
    }
  },
  {
    "type": "mapgen",
    "method": "json",
    "nested_mapgen_id": "radio_tower_2x2_map",
    "object": {
      "mapgensize": [ 2, 2 ],
      "place_loot": [
        { "item": "survivor_scope", "x": 1, "y": 0 },
        { "item": "survivormap", "x": 1, "y": 0 },
        { "item": "3006", "x": 1, "y": 0, "chance": 40 }
      ]
    }
  }
]
